2 2 2 2 2 2 2 2 2 2 2 2 2 2 2 2 2 2 2 2 2 2 2 2 2 2 2 2 2 2 2 2 2 2 2 2 2 2 2 2 2 2 2 2 2 2 2 2 2 2 2 2 2 2 2 2 2 2 2 2 2 2 2 2 
2 11 11 10 11 10 9 11 9 9 11 9 11 9 10 11 11 9 10 11 10 11 9 9 10 10 9 9 11 11 10 10 11 11 9 11 11 11 10 11 10 11 9 11 11 11 9 10 11 11 10 9 11 9 11 9 10 9 9 10 10 11 9 2 
2 11 10 11 10 11 10 9 11 9 11 10 11 10 11 11 11 11 9 11 10 9 11 11 10 11 10 9 10 11 9 9 10 11 11 10 9 11 11 11 11 9 11 11 11 9 10 10 11 9 10 9 9 11 9 10 9 9 11 11 10 11 11 2 
2 10 11 9 11 11 10 10 9 11 10 10 11 10 11 11 9 9 10 9 10 9 9 10 11 10 11 9 9 10 10 9 11 9 11 10 9 9 9 10 10 9 10 9 9 10 11 11 10 9 9 10 9 10 9 9 9 10 10 11 11 11 11 2 
2 11 11 10 10 10 11 9 10 9 10 10 9 10 11 11 10 10 10 9 10 11 9 9 9 10 10 9 10 9 11 11 9 11 11 10 10 11 9 9 11 11 9 11 10 9 9 11 9 10 11 11 11 10 11 11 11 10 10 9 11 10 10 2 
2 10 10 9 11 9 9 10 11 11 9 10 9 11 9 11 9 11 11 10 9 11 11 11 11 11 10 10 9 11 10 11 9 9 9 9 10 10 11 9 10 9 11 9 10 9 10 10 9 10 10 10 9 11 11 11 11 11 11 11 11 9 9 2 
2 9 10 10 9 9 10 11 11 10 10 10 10 10 11 11 10 10 11 11 11 9 10 10 10 9 9 10 11 10 10 11 10 10 10 9 11 9 9 11 9 10 10 9 9 10 11 10 10 9 9 9 10 10 9 10 11 9 11 9 9 10 9 2 
2 9 10 9 11 9 9 10 10 10 9 10 10 11 10 11 9 10 10 10 11 11 11 11 10 10 11 9 11 11 9 11 9 10 11 9 11 11 9 10 9 9 11 10 9 11 10 11 9 9 10 9 9 9 10 9 10 9 9 10 11 11 9 2 
2 11 10 11 10 11 11 9 11 10 11 9 9 10 11 9 11 10 9 10 11 10 11 9 10 9 9 10 11 11 11 11 11 9 11 9 9 11 9 10 10 9 11 10 10 11 11 11 11 10 9 11 10 9 10 10 10 9 10 10 10 11 10 2 
2 11 9 10 9 10 11 9 9 11 11 11 9 10 11 11 9 11 10 10 10 10 11 10 9 10 10 10 10 10 10 11 11 11 9 11 11 11 9 10 9 10 9 9 10 10 11 11 10 10 10 11 9 11 10 9 9 10 11 10 10 11 9 2 
2 11 9 11 11 10 9 10 10 10 10 10 9 11 11 10 10 9 11 11 11 9 11 10 10 9 9 9 9 9 9 11 10 9 10 10 9 9 9 11 10 9 10 10 10 11 9 11 9 11 11 10 11 10 11 11 11 10 10 9 11 11 11 2 
2 11 10 10 11 10 9 9 9 11 10 11 11 10 9 10 10 10 9 11 10 9 9 10 11 11 9 10 11 11 9 11 9 11 11 11 11 11 9 11 10 11 10 10 10 10 11 11 9 11 10 9 9 10 11 10 10 11 9 11 11 11 11 2 
2 9 9 11 9 10 11 11 9 11 10 11 11 10 11 10 11 11 11 11 11 11 9 9 9 10 9 11 9 10 9 9 10 10 10 11 11 9 11 9 9 10 10 10 10 10 10 10 10 11 11 11 11 9 11 9 11 11 11 10 11 11 11 2 
2 9 11 9 9 10 9 11 9 11 11 10 11 10 9 9 9 9 9 10 11 10 11 9 11 11 10 11 11 11 10 11 11 9 11 10 11 11 9 11 11 9 10 9 9 9 9 11 9 10 10 10 11 11 11 11 10 11 10 10 10 9 11 2 
2 10 11 11 11 11 9 9 10 9 11 11 10 9 10 9 9 11 10 11 10 10 11 10 11 11 9 10 11 10 9 11 11 9 10 9 9 11 11 10 10 9 10 10 9 10 9 9 11 11 10 10 9 9 9 9 9 9 11 11 9 11 11 2 
2 9 10 10 11 9 10 10 11 11 11 9 10 9 11 9 10 11 11 10 10 9 9 11 11 9 9 10 11 9 10 9 10 10 10 9 9 10 10 10 9 10 10 11 9 11 10 9 10 9 11 11 11 11 9 10 10 10 9 10 10 11 9 2 
2 9 11 9 11 9 9 10 11 11 10 9 11 10 11 10 11 10 11 10 11 11 10 11 11 9 9 10 9 9 11 11 10 10 11 11 10 11 10 11 11 9 9 9 11 9 11 11 10 11 9 11 9 9 9 9 9 10 10 11 10 9 9 2 
2 11 9 10 11 9 9 10 11 11 10 10 10 11 9 9 11 9 9 9 10 9 9 11 9 11 11 10 11 9 9 10 10 9 11 11 9 11 11 11 11 11 11 9 11 11 10 11 9 9 9 9 9 9 9 10 11 11 11 9 11 9 11 2 
2 9 9 11 9 9 10 9 9 10 9 11 10 10 10 9 11 10 11 11 11 11 11 9 11 10 10 10 11 11 9 9 10 9 11 10 9 11 9 11 9 10 11 11 11 11 10 10 9 9 9 11 9 9 9 11 11 9 9 11 9 11 9 2 
2 9 10 9 11 9 10 11 9 11 9 10 9 11 9 11 11 10 11 10 10 9 9 10 9 11 11 10 11 9 11 9 11 11 9 11 9 11 10 10 10 9 9 9 11 11 11 11 11 9 9 11 11 10 9 10 10 11 10 10 9 9 11 2 
2 9 11 9 10 10 10 9 10 10 9 9 9 10 9 9 9 9 9 11 10 9 10 10 10 10 9 10 10 11 11 11 10 11 10 10 10 9 10 10 10 11 10 9 10 11 10 11 10 9 11 11 11 9 9 11 9 9 9 9 9 10 10 2 
2 9 10 9 9 9 9 11 9 10 11 11 9 9 11 11 9 9 9 10 11 9 9 9 10 9 10 9 11 9 11 11 9 11 9 11 10 9 11 11 9 11 10 11 10 11 10 11 10 9 11 9 9 11 9 10 9 11 9 11 11 9 10 2 
2 10 11 10 9 11 11 11 9 11 10 10 10 9 11 10 11 10 11 10 11 9 11 10 11 9 9 10 9 10 9 11 10 11 9 9 9 10 10 11 9 9 11 10 9 9 10 10 9 9 9 9 11 11 11 11 10 10 9 11 11 9 10 2 
2 10 11 11 9 9 11 11 10 9 9 11 10 10 9 9 10 10 9 10 10 11 10 9 11 11 9 11 11 9 10 11 9 10 11 9 11 10 9 9 9 11 10 11 9 10 11 11 10 11 11 11 11 9 10 9 9 10 10 9 10 11 10 2 
2 10 9 11 9 10 10 9 10 11 10 10 10 10 10 11 10 11 10 11 10 9 9 11 9 9 11 9 10 9 9 11 10 9 10 9 10 9 11 10 9 10 10 11 9 10 10 11 9 9 9 9 10 11 10 9 10 10 10 11 11 11 10 2 
2 9 11 11 11 10 11 9 10 10 11 9 11 9 9 11 11 9 9 9 11 11 9 9 9 11 10 9 9 9 9 10 9 9 11 9 9 11 10 10 10 11 11 10 11 11 11 11 10 11 10 11 9 11 10 10 9 9 10 11 11 10 11 2 
2 11 10 11 10 11 11 9 9 10 9 9 10 11 10 9 10 10 9 11 11 10 10 11 11 11 10 9 9 9 9 10 11 10 9 9 11 10 11 11 11 11 11 9 11 11 11 10 11 11 11 11 9 10 9 9 9 9 11 11 9 9 9 2 
2 9 10 9 10 10 11 9 10 9 11 9 11 10 9 11 9 10 9 10 10 9 11 9 10 11 11 9 10 11 10 10 9 10 9 11 9 11 10 10 10 10 9 11 9 9 11 9 11 11 10 9 10 9 11 11 11 10 11 9 11 11 10 2 
2 10 9 11 10 10 11 10 9 10 11 10 11 9 10 9 9 10 11 11 10 9 10 9 11 10 11 9 10 11 9 9 9 11 9 10 11 9 10 11 9 9 11 9 11 10 9 10 11 10 11 9 11 9 11 10 10 11 11 9 9 9 11 2 
2 10 11 9 11 10 9 9 11 10 11 10 11 10 9 11 9 10 10 9 10 9 10 11 11 11 9 11 9 11 11 10 10 10 9 9 9 9 9 11 11 11 9 11 11 9 11 9 9 11 11 9 11 11 10 11 10 9 11 9 10 9 11 2 
2 11 9 9 11 11 9 11 11 11 9 11 11 9 10 11 10 9 10 9 11 11 10 11 10 9 9 9 10 9 11 10 10 9 10 10 9 10 9 10 10 11 11 11 10 11 10 10 9 11 9 11 11 9 10 9 9 11 11 10 10 9 11 2 
2 9 11 9 11 11 10 11 9 10 11 10 11 10 10 10 10 10 10 10 9 10 11 11 10 11 11 9 9 9 9 11 11 10 11 9 9 10 11 10 11 11 9 11 11 10 9 10 10 9 9 9 11 10 10 11 9 10 11 11 9 10 9 2 
2 10 11 10 10 11 11 10 2 2 2 2 2 2 2 2 2 2 2 2 2 2 2 11 10 11 11 9 11 9 11 9 10 9 9 9 9 9 11 10 11 11 11 9 10 10 11 10 9 9 10 11 10 10 10 10 11 10 11 11 9 11 10 2 
2 11 11 10 11 11 11 10 2 2 2 2 2 2 2 2 2 2 2 2 2 2 2 9 9 11 11 10 9 10 11 9 10 10 11 9 9 9 9 9 10 11 9 10 10 10 11 9 9 10 11 11 11 10 10 9 11 9 9 11 11 9 10 2 
2 9 9 9 10 10 10 11 2 2 2 2 2 2 2 2 2 2 2 2 2 2 2 9 11 10 11 9 10 11 10 10 9 9 11 10 10 11 9 11 10 10 9 9 10 10 9 9 11 10 11 10 10 10 10 11 11 10 10 11 11 10 10 2 
2 11 10 9 9 11 10 10 2 2 2 2 2 2 2 2 2 2 2 2 2 2 2 10 9 11 11 11 10 10 11 10 11 10 10 9 9 10 10 9 9 9 9 10 10 11 10 11 11 11 9 9 11 10 9 9 10 9 11 10 9 10 11 2 
2 10 10 11 9 11 9 9 2 2 2 2 2 2 2 2 2 2 2 2 2 2 2 10 9 10 10 11 11 10 10 9 10 11 10 9 9 9 11 11 11 9 10 9 9 10 11 10 9 10 10 9 11 11 9 9 10 10 10 11 11 10 10 2 
2 10 11 10 9 9 9 9 2 2 2 2 2 2 2 2 2 2 2 2 2 2 2 10 10 9 10 10 11 11 11 9 9 9 9 9 10 10 9 10 10 9 10 11 10 9 9 9 9 10 11 11 11 11 10 9 9 11 9 11 11 9 11 2 
2 10 9 11 11 11 9 10 2 2 2 2 2 2 2 2 2 2 2 2 2 2 2 9 9 9 9 10 10 9 11 10 11 9 10 10 10 9 9 10 9 10 10 11 11 10 10 9 9 10 9 9 11 11 9 9 10 11 10 10 10 11 11 2 
2 9 10 9 9 11 11 10 2 2 2 2 2 2 2 2 2 2 2 2 2 2 2 10 9 9 11 10 11 9 11 10 10 10 11 11 9 10 11 10 11 10 11 9 11 9 9 10 10 11 10 10 9 9 10 10 11 11 10 9 10 11 11 2 
2 11 11 10 11 9 9 10 2 2 2 2 2 2 2 2 2 2 2 2 2 2 2 9 9 11 11 11 10 10 10 10 10 11 10 11 9 10 11 9 10 10 10 11 9 11 10 9 11 9 9 9 9 11 9 9 11 10 10 9 11 9 9 2 
2 10 10 11 9 9 11 10 2 2 2 2 2 2 2 2 2 2 2 2 2 2 2 11 10 9 11 9 10 11 11 10 11 9 10 10 10 10 10 9 10 11 9 9 9 10 11 9 9 10 9 11 10 10 11 11 10 11 9 11 11 9 11 2 
2 11 11 9 11 9 10 9 2 2 2 2 2 2 2 2 2 2 2 2 2 2 2 9 10 10 9 11 10 11 10 11 10 11 11 9 9 11 9 11 9 9 10 11 11 11 10 9 11 11 9 9 10 10 11 10 11 9 10 11 10 9 10 2 
2 10 11 9 10 10 10 11 2 2 2 2 2 2 2 2 2 2 2 2 2 2 2 11 11 9 10 10 11 10 11 11 10 9 11 11 10 11 11 10 11 11 11 10 11 9 11 10 10 9 9 11 10 10 11 10 11 11 11 9 11 11 9 2 
2 11 11 11 10 9 11 11 2 2 2 2 2 2 2 2 2 2 2 2 2 2 2 10 11 10 9 11 9 9 11 10 11 10 11 9 9 9 9 11 10 9 9 11 9 11 11 9 10 11 11 9 10 11 11 9 9 9 9 10 9 11 9 2 
2 9 9 11 9 9 10 10 2 2 2 2 2 2 2 2 2 2 2 2 2 2 2 11 9 11 11 9 9 10 11 11 9 11 11 10 11 11 10 10 9 11 9 9 10 11 9 9 9 10 10 11 9 11 11 10 11 11 11 11 11 9 10 2 
2 10 11 10 10 9 9 10 2 2 2 2 2 2 2 2 2 2 2 2 2 2 2 9 9 11 10 9 10 9 9 11 9 11 9 10 11 10 11 10 11 11 10 10 10 11 11 11 11 9 10 9 11 9 9 9 10 10 10 9 9 9 10 2 
2 11 10 10 9 9 11 10 11 11 9 10 9 9 11 11 11 9 11 10 9 11 9 10 9 11 11 11 11 10 9 9 10 11 11 9 9 10 9 10 9 9 11 9 11 9 10 10 11 10 10 9 10 9 10 10 10 9 10 10 9 9 9 2 
2 10 10 10 9 11 11 11 9 9 9 11 10 11 10 10 11 9 11 10 10 10 9 9 9 9 9 11 10 9 9 9 9 10 9 10 10 11 10 9 10 11 10 10 9 11 10 9 10 11 10 9 11 11 10 10 11 11 10 10 11 10 9 2 
2 10 9 9 11 10 11 11 9 9 11 11 11 11 10 9 11 9 10 11 10 11 9 11 11 9 11 9 9 11 11 9 10 11 9 10 9 9 11 10 11 11 9 10 11 11 9 10 11 9 9 9 9 10 10 10 11 10 9 11 11 11 9 2 
2 10 9 10 9 9 11 9 9 11 10 11 9 9 9 10 9 10 10 9 9 10 11 9 9 9 11 9 11 11 10 9 10 9 9 11 10 9 11 10 11 10 9 11 10 10 10 9 9 11 10 10 11 10 11 9 10 10 11 9 11 9 10 2 
2 11 10 10 9 9 10 9 9 11 9 10 9 11 10 9 9 11 9 11 11 9 11 10 10 9 11 11 11 10 11 9 11 9 9 9 9 9 11 9 10 9 9 9 11 11 10 9 10 10 9 10 10 10 11 10 11 11 11 11 10 11 11 2 
2 11 10 11 9 11 9 9 11 11 11 9 11 9 9 11 11 9 11 10 10 10 11 9 10 10 9 9 10 9 9 11 10 10 10 10 11 11 9 9 9 11 10 9 10 11 10 10 10 10 11 11 9 10 10 10 9 10 9 9 9 11 10 2 
2 9 10 11 9 9 10 11 11 9 11 11 10 10 9 11 10 9 11 11 9 11 10 9 10 10 11 11 10 10 11 10 10 11 10 11 11 11 9 9 9 11 9 9 11 9 10 9 10 11 11 11 10 11 11 10 9 10 11 9 11 9 9 2 
2 9 11 10 10 9 10 11 9 11 9 9 10 10 9 11 10 10 10 10 9 10 11 9 9 9 11 10 11 10 10 11 9 11 9 11 11 11 10 11 10 9 9 9 10 11 9 11 9 11 11 11 11 10 9 10 11 10 10 10 10 11 9 2 
2 10 9 9 11 10 10 11 9 11 10 9 11 11 11 9 9 9 11 10 10 10 9 11 9 9 11 9 11 10 10 11 10 10 10 11 9 9 10 11 11 9 10 11 11 9 10 11 11 9 11 10 11 9 10 10 11 9 9 11 10 11 11 2 
2 9 11 11 11 10 11 10 9 10 10 9 9 9 10 9 11 10 9 9 10 9 10 9 9 11 10 11 11 10 9 9 11 9 9 11 11 9 10 10 11 10 11 9 11 11 9 11 9 11 10 9 10 11 10 11 11 9 10 10 9 11 10 2 
2 11 10 9 10 11 9 11 11 9 10 10 11 11 11 9 11 10 11 9 11 10 9 11 10 11 9 9 9 11 10 10 11 11 9 11 11 9 11 10 10 11 9 9 10 11 10 11 9 10 10 11 9 11 10 10 11 9 11 9 11 11 9 2 
2 9 9 10 10 10 11 10 11 11 10 9 11 10 10 11 11 11 11 11 9 10 11 11 11 10 11 9 9 11 9 10 9 10 11 9 10 10 11 11 9 9 9 9 9 10 10 10 11 11 11 10 10 9 9 10 11 11 10 11 11 11 11 2 
2 10 9 9 11 10 11 11 9 10 10 10 10 9 10 10 11 9 11 9 9 10 10 10 9 9 9 11 11 9 10 9 9 9 10 10 11 10 9 10 11 11 11 10 10 9 9 11 10 9 10 11 10 10 10 10 9 9 9 10 11 11 9 2 
2 10 11 11 11 9 9 10 9 10 9 11 9 9 9 9 11 11 10 11 11 10 11 11 9 11 11 11 10 11 11 9 11 10 11 11 10 11 9 10 11 11 11 11 9 10 9 11 10 11 10 11 9 9 11 9 10 11 9 10 11 9 11 2 
2 9 11 10 11 11 9 11 11 11 11 9 11 11 10 10 10 9 10 11 10 9 9 9 10 11 9 9 10 11 11 9 10 9 9 11 10 10 11 9 9 9 9 9 10 10 9 9 11 9 11 11 9 9 9 11 9 9 10 10 9 10 9 2 
2 11 10 10 11 10 9 10 11 11 10 11 11 10 11 9 10 9 10 10 9 9 10 10 9 9 10 11 10 11 10 9 11 11 10 10 11 9 10 9 10 9 10 9 9 9 10 9 9 9 9 11 11 9 10 11 9 10 11 10 10 11 11 2 
2 2 2 2 2 2 2 2 2 2 2 2 2 2 2 2 2 2 2 2 2 2 2 2 2 2 2 2 2 2 2 2 2 2 2 2 2 2 2 2 2 2 2 2 2 2 2 2 2 2 2 2 2 2 2 2 2 2 2 2 2 2 2 2 
