4 4 4 4 4 4 4 4 4 4 4 4 4 4 4 4 4 4 4 4 4 4 4 4 4 4 4 4 4 4 4 4 4 4 4 4 4 4 4 4 4 4 4 4 4 4 4 4 4 4 4 4 4 4 4 4 4 4 4 4 4 4 4 4 
4 7 8 8 7 8 7 7 8 7 8 7 8 7 7 8 7 7 8 8 7 7 8 7 8 7 8 7 7 7 7 8 8 8 8 7 7 8 7 7 8 8 7 7 8 8 8 8 8 7 7 8 7 8 7 7 7 7 8 8 7 7 7 4 
4 7 8 7 7 8 8 8 7 8 8 8 8 7 8 7 7 7 8 7 7 7 7 7 8 8 8 7 8 8 7 7 7 8 7 8 8 7 8 8 8 8 7 7 8 7 8 7 8 7 7 7 8 7 7 8 8 8 8 8 8 8 7 4 
4 8 7 8 7 7 7 7 7 7 7 7 8 8 7 7 7 7 7 8 8 7 7 8 8 7 7 8 7 8 7 7 8 7 8 7 8 7 7 7 8 7 8 8 8 7 7 8 8 8 7 8 8 7 7 8 8 7 7 7 7 8 7 4 
4 7 7 8 8 8 7 8 8 7 7 8 7 8 7 8 8 7 7 7 7 7 7 7 8 7 7 8 8 7 8 7 7 7 8 8 8 7 8 7 7 8 7 8 8 7 7 7 7 7 7 7 8 8 7 8 7 8 7 7 8 8 8 4 
4 7 8 8 7 7 7 8 8 8 7 7 7 8 7 8 8 7 8 8 7 8 7 8 7 7 7 8 8 7 8 8 8 7 7 7 8 7 7 8 7 7 7 7 8 7 8 7 7 7 8 8 7 7 8 8 8 7 7 8 8 8 8 4 
4 7 7 7 7 7 8 8 7 8 8 8 8 7 8 8 8 7 8 7 8 7 8 8 7 7 8 7 8 7 7 8 7 7 8 8 7 7 7 7 7 8 7 7 8 7 8 8 7 8 7 8 7 8 7 8 8 7 7 8 7 8 7 4 
4 8 8 7 7 7 8 7 8 8 7 7 8 8 7 8 7 7 7 7 7 8 7 8 7 7 8 7 7 8 8 7 8 8 7 7 8 7 8 8 7 7 7 7 8 8 8 7 8 7 8 7 7 7 7 8 8 8 8 7 8 8 7 4 
4 7 7 7 8 7 8 8 7 7 8 8 8 7 8 8 8 7 8 8 7 8 7 8 8 8 7 8 7 7 7 7 7 7 7 7 8 8 8 8 8 8 8 8 7 7 8 8 7 8 7 7 7 7 7 7 8 8 8 7 8 7 8 4 
4 7 8 7 7 7 7 6 7 7 8 8 8 7 8 8 7 7 8 8 7 8 8 7 8 7 8 7 7 7 7 7 7 7 8 7 7 7 8 8 8 7 7 8 8 8 8 8 8 8 7 8 8 8 8 8 7 7 8 7 7 7 7 4 
4 7 7 8 7 7 7 7 8 7 8 8 8 7 7 7 7 7 8 8 8 8 8 8 8 8 7 7 7 7 7 7 7 8 7 7 8 8 7 7 8 8 8 8 7 7 8 8 8 8 8 8 7 8 8 8 8 7 7 7 8 8 8 4 
4 7 8 8 7 7 7 8 7 8 8 8 8 7 8 8 8 8 8 7 7 8 8 8 8 7 7 8 8 7 8 7 8 8 8 7 8 8 8 8 8 8 8 8 7 8 7 8 7 8 7 8 8 7 7 8 8 8 8 8 7 7 8 4 
4 8 8 7 8 7 8 8 7 8 8 7 8 7 8 7 7 7 8 8 7 8 7 7 8 7 7 8 8 8 7 7 8 8 7 7 8 7 8 7 8 7 8 7 7 7 8 7 8 7 7 7 7 8 8 7 7 8 8 8 7 8 8 4 
4 8 7 7 8 7 8 7 8 8 8 8 7 7 7 8 7 8 7 7 8 7 8 7 7 7 8 7 7 7 8 8 7 8 8 7 8 8 8 8 8 7 8 8 8 8 7 8 8 8 7 7 7 7 7 7 8 7 8 7 8 8 7 4 
4 7 8 8 8 8 7 7 8 7 7 8 7 7 7 8 7 8 8 8 8 7 7 7 8 8 8 8 8 7 8 8 8 7 7 8 8 7 7 7 8 8 8 7 8 7 8 8 7 8 8 7 8 8 7 8 7 7 7 7 7 8 8 4 
4 8 7 8 8 7 8 8 8 8 7 8 7 7 8 8 8 8 7 8 8 7 8 7 8 8 7 7 8 8 7 8 7 8 8 8 8 8 8 7 7 7 7 7 8 8 7 8 7 8 7 8 8 8 7 7 7 8 8 7 8 8 8 4 
4 7 8 7 7 7 8 8 7 7 7 8 8 7 8 7 7 7 7 8 7 7 8 7 7 8 7 8 8 8 7 7 7 7 7 8 7 8 7 8 7 8 7 8 7 8 7 8 7 7 7 7 8 8 7 7 8 7 7 7 7 7 7 4 
4 7 7 7 7 7 7 8 8 7 7 7 7 8 8 7 8 7 7 8 7 8 8 8 8 7 8 7 8 7 8 8 8 7 7 8 7 7 8 8 8 7 7 7 7 8 8 7 7 8 8 7 8 7 8 8 7 7 7 7 7 7 8 4 
4 8 8 7 7 7 8 7 8 7 7 7 7 7 7 7 7 8 8 7 8 8 7 8 8 8 7 8 8 7 7 7 7 8 8 7 7 8 7 8 7 7 7 7 7 8 7 7 7 8 8 7 7 8 8 8 8 7 7 8 7 8 8 4 
4 8 8 8 7 8 8 8 8 8 8 8 7 8 8 8 7 8 7 7 8 7 7 7 7 7 8 8 8 7 7 7 7 8 7 7 7 7 7 7 7 7 8 7 8 8 7 7 7 7 8 8 7 8 8 7 7 8 7 7 8 7 8 4 
4 8 7 8 7 7 8 8 8 7 7 7 7 7 7 7 7 8 7 8 8 7 7 7 7 7 8 8 7 8 7 8 7 8 8 7 7 7 8 7 8 8 8 8 8 7 8 8 7 8 7 7 7 8 7 7 7 8 7 8 7 8 7 4 
4 8 7 7 8 8 8 7 7 7 7 7 8 7 8 7 8 7 7 7 7 8 8 7 8 7 8 7 8 7 8 7 8 8 7 7 8 8 8 8 7 8 7 7 7 7 7 7 8 7 7 7 8 8 8 8 8 8 8 7 8 7 8 4 
4 8 7 8 7 8 7 8 8 7 8 7 8 7 7 7 8 7 7 8 7 8 8 8 8 7 7 7 8 8 7 8 8 8 8 8 8 8 7 8 8 7 8 8 7 8 8 8 8 7 7 8 7 8 8 8 8 8 8 7 7 8 8 4 
4 8 7 7 7 7 8 8 8 8 8 7 7 8 7 7 8 8 7 7 7 7 8 8 7 7 8 7 7 8 8 7 7 7 8 7 7 8 7 8 7 7 7 8 7 8 7 7 7 7 7 8 7 7 8 8 7 8 8 7 8 8 8 4 
4 7 8 7 8 8 7 7 8 7 7 8 8 7 8 8 8 8 8 8 7 8 7 7 7 7 7 8 7 8 7 8 8 8 8 7 7 7 8 7 8 8 7 8 8 7 7 8 7 7 7 8 8 7 7 7 8 8 7 8 8 8 8 4 
4 8 8 7 7 8 7 8 7 8 8 7 8 7 7 7 8 7 7 8 7 8 7 8 7 8 7 7 7 7 8 7 8 8 8 7 8 7 7 8 7 7 7 8 7 8 7 8 7 8 8 8 8 8 7 8 8 8 7 7 7 7 7 4 
4 7 7 8 8 8 7 8 8 7 8 7 7 8 7 8 8 8 8 7 8 7 7 8 7 7 8 8 8 7 7 7 7 8 7 7 7 8 7 7 7 7 8 8 8 7 8 8 8 7 8 8 7 7 7 7 8 8 7 8 7 7 7 4 
4 8 8 7 7 7 7 8 8 7 7 8 8 8 8 7 7 7 8 8 8 7 7 8 7 8 7 8 8 8 7 7 8 8 8 8 7 8 7 7 8 7 7 8 7 8 8 7 8 7 7 7 8 7 7 7 8 7 7 8 7 7 8 4 
4 8 8 7 7 7 8 8 8 7 8 7 8 7 7 7 7 8 7 8 8 8 7 8 8 8 8 8 8 7 8 8 8 8 7 8 7 8 7 7 8 8 8 7 8 8 7 7 7 8 7 8 7 7 7 8 7 8 8 8 8 8 7 4 
4 7 7 7 8 7 8 7 8 7 7 8 8 8 7 7 8 7 8 7 8 7 8 7 7 8 8 8 7 7 8 8 7 7 8 8 7 8 8 7 7 8 8 8 7 7 8 8 7 8 8 7 7 8 8 7 8 7 8 7 7 8 8 4 
4 7 7 8 7 7 8 7 8 8 8 8 7 7 7 7 8 7 7 7 7 8 7 7 8 8 8 8 8 7 7 7 7 7 8 8 7 8 8 8 8 7 8 8 8 8 7 8 8 8 8 7 7 8 8 8 7 7 8 7 7 7 7 4 
4 7 7 7 7 7 8 8 7 8 8 7 7 8 7 7 8 8 8 7 7 8 7 8 7 7 7 8 7 7 8 7 7 8 7 8 7 7 7 7 7 8 7 7 7 7 8 7 8 8 8 7 8 8 8 7 7 7 8 8 8 8 7 4 
4 7 8 8 7 8 7 8 8 7 7 7 7 7 8 8 7 8 7 8 7 8 8 8 7 7 8 7 7 7 7 8 7 8 8 7 8 7 8 7 8 7 7 7 7 8 7 8 7 7 8 7 7 8 8 8 7 7 8 8 8 7 7 4 
4 8 7 8 7 7 8 8 7 7 7 8 7 7 7 7 8 7 8 8 8 7 8 7 8 8 8 8 7 8 8 8 7 7 8 7 7 7 8 7 8 7 7 7 7 8 8 8 7 7 7 8 7 8 8 8 8 8 7 7 7 7 7 4 
4 7 8 8 7 7 8 8 8 7 7 7 7 7 7 7 8 8 8 8 7 7 8 8 8 7 7 8 7 8 8 8 8 8 8 8 7 8 7 7 7 8 8 7 7 8 8 7 7 8 8 8 8 7 8 8 8 8 7 7 7 8 8 4 
4 8 7 7 7 7 8 7 8 8 8 8 8 7 8 7 7 7 8 7 8 8 7 7 8 8 7 8 7 7 7 7 8 7 8 8 7 7 7 7 8 8 7 8 8 8 8 7 7 7 8 7 8 8 7 8 7 7 8 8 8 7 7 4 
4 8 7 7 7 8 7 8 8 7 8 8 7 7 8 8 8 8 8 7 8 8 8 7 8 8 8 8 7 8 7 8 8 8 8 7 7 7 7 7 8 8 8 7 8 8 7 7 8 8 8 7 8 7 8 8 7 7 8 8 8 8 7 4 
4 8 8 7 7 7 7 8 8 7 8 8 7 7 7 8 8 8 7 7 7 7 7 8 8 8 7 7 8 7 8 8 7 8 7 7 8 8 8 7 7 8 7 7 7 8 7 8 8 8 8 8 8 7 7 8 8 8 7 7 7 7 7 4 
4 7 7 8 7 8 8 7 7 8 8 8 8 8 8 8 7 8 8 8 8 7 8 8 8 8 8 8 7 7 8 7 8 8 7 7 7 7 7 7 7 8 7 7 8 7 7 8 7 8 8 8 8 7 8 8 8 7 7 8 7 7 7 4 
4 8 8 8 8 8 7 8 7 7 8 8 8 7 7 7 8 7 7 8 7 7 7 8 7 7 8 7 7 8 7 8 7 8 7 7 8 8 7 7 8 8 8 7 7 7 8 8 8 8 7 8 7 8 7 8 8 8 7 7 7 7 7 4 
4 8 8 8 7 7 7 8 7 7 7 7 7 8 7 7 8 8 7 7 7 8 8 8 7 7 7 8 8 7 8 8 7 7 8 7 8 8 7 7 8 8 8 8 8 7 8 8 8 8 8 8 8 8 7 7 8 7 8 7 8 7 8 4 
4 7 7 8 8 7 8 7 7 7 7 7 8 7 8 8 8 7 8 7 7 7 7 8 8 7 7 7 7 8 7 7 8 8 7 7 7 7 8 7 7 8 7 8 7 7 7 7 7 8 8 7 8 8 8 8 8 8 7 8 8 7 7 4 
4 7 7 8 7 7 7 8 7 7 7 7 7 8 8 8 7 7 8 8 7 8 7 8 8 7 8 7 8 7 7 8 7 7 8 7 8 8 7 8 8 7 7 7 8 8 7 7 7 8 8 8 7 7 7 7 8 8 8 7 8 8 7 4 
4 8 8 8 8 7 7 7 7 8 7 7 8 7 7 8 7 8 8 8 7 8 7 7 7 8 7 7 8 8 8 8 8 7 7 8 7 7 8 8 8 8 8 8 7 8 8 8 8 8 7 8 8 7 8 8 8 8 7 8 8 7 7 4 
4 7 7 8 7 8 7 7 7 7 7 7 8 7 8 8 7 7 8 7 8 8 8 7 7 7 7 8 8 8 7 7 8 7 7 7 7 7 8 7 7 8 8 7 7 7 7 7 8 7 7 8 7 7 8 7 8 7 8 8 8 8 8 4 
4 8 7 7 8 7 7 7 8 8 8 7 8 7 7 8 7 7 8 7 7 8 7 8 7 7 8 8 8 7 7 7 8 8 8 8 8 7 7 7 7 8 7 7 8 8 8 8 8 8 8 7 8 8 7 8 7 8 8 8 7 7 7 4 
4 7 7 7 7 8 8 8 7 8 8 7 7 8 7 8 7 8 7 8 7 7 8 7 8 8 7 7 7 7 8 7 8 7 7 7 7 7 7 7 7 8 7 8 7 7 8 8 7 8 8 7 7 8 7 7 8 8 7 7 7 7 7 4 
4 8 7 8 7 8 8 7 8 7 8 7 7 7 7 7 7 7 8 7 8 8 8 8 8 8 7 8 8 8 8 7 8 7 8 8 8 8 7 8 7 8 8 7 7 8 8 8 8 8 8 8 8 8 8 7 7 8 7 8 8 7 8 4 
4 8 8 7 8 7 8 7 7 8 7 7 8 8 7 8 7 7 7 7 8 7 8 7 7 8 8 8 7 8 8 7 8 8 7 7 8 8 7 8 7 7 8 8 8 7 7 8 8 7 7 7 7 7 7 8 8 8 7 7 7 7 8 4 
4 8 7 8 7 7 8 8 7 8 7 7 7 8 7 8 7 8 8 8 7 8 8 8 7 7 7 8 8 8 8 8 7 8 7 8 8 8 7 8 8 8 8 7 8 7 7 7 7 8 8 7 7 7 7 8 7 8 8 8 7 8 8 4 
4 7 7 7 8 8 8 7 8 7 8 8 8 8 7 7 7 8 8 7 8 8 8 8 8 7 8 7 7 7 7 7 8 8 7 7 7 8 8 8 7 8 7 8 7 7 7 8 8 7 8 7 7 7 8 7 7 8 8 7 7 7 7 4 
4 8 8 8 8 7 8 7 8 8 7 8 8 7 8 8 7 8 8 7 7 8 7 8 8 7 7 7 8 8 8 8 7 7 7 7 7 8 7 8 7 7 8 8 7 8 8 8 8 8 7 8 8 8 7 8 7 7 7 8 7 8 8 4 
4 8 8 7 7 7 7 8 7 8 8 7 8 7 8 8 7 8 8 8 8 8 8 8 8 8 7 7 8 8 7 8 7 8 8 8 7 8 8 7 7 7 8 8 8 8 7 7 8 8 8 8 8 8 8 8 8 8 8 8 7 7 7 4 
4 8 7 7 7 8 8 8 8 8 7 7 7 8 7 8 7 7 7 8 7 7 7 8 7 8 8 7 7 8 8 8 7 7 7 8 8 7 7 8 8 7 8 7 7 7 7 8 7 8 8 8 7 8 8 7 8 8 7 7 7 8 7 4 
4 8 7 8 7 7 7 8 7 7 7 8 7 7 8 7 7 7 7 7 7 7 7 7 8 8 8 8 7 8 8 7 7 8 8 7 7 7 8 7 8 7 7 7 7 7 8 8 7 8 8 7 7 8 7 7 8 8 8 7 7 8 7 4 
4 8 7 8 8 8 7 8 7 7 7 7 8 8 8 8 8 7 8 8 8 8 8 7 8 8 8 8 7 7 8 7 7 8 8 8 8 8 7 8 8 8 8 8 7 8 8 8 7 7 7 8 7 7 7 8 8 7 7 8 7 8 8 4 
4 7 7 7 7 7 8 8 8 7 7 8 7 8 7 7 7 7 7 8 8 8 7 8 7 7 8 8 8 8 7 7 7 7 8 7 7 7 8 8 8 8 8 8 8 7 8 8 7 7 7 7 7 7 8 8 8 8 8 7 8 7 8 4 
4 8 7 8 8 7 7 8 8 8 8 7 7 8 7 7 7 8 7 7 7 8 8 7 8 7 8 8 7 8 8 7 7 7 8 8 7 7 8 8 7 7 7 7 7 7 7 7 7 7 7 8 8 8 8 7 7 8 8 8 7 8 8 4 
4 7 7 8 8 8 7 8 7 7 7 8 7 7 8 8 8 7 7 8 7 7 8 8 8 7 8 8 8 8 8 8 7 7 8 8 7 7 8 8 7 7 8 8 7 8 8 8 7 7 7 8 8 7 7 8 7 8 8 7 7 7 8 4 
4 8 7 7 8 7 8 8 7 7 8 8 8 7 8 8 7 8 8 7 8 8 7 7 8 7 8 8 7 7 7 8 8 8 7 7 8 7 7 7 7 8 8 7 8 8 7 7 8 7 8 8 7 8 8 8 7 8 8 8 8 8 8 4 
4 7 8 7 8 8 7 7 7 8 8 8 7 8 7 8 7 8 8 7 8 7 8 8 8 7 7 8 7 8 7 7 8 7 7 8 7 7 8 7 8 7 7 7 8 8 8 7 8 8 8 8 8 7 8 8 8 8 8 7 7 8 8 4 
4 8 7 7 7 7 7 8 8 8 7 8 7 8 8 7 7 7 8 8 7 7 8 8 8 7 7 7 8 8 8 8 7 8 7 8 7 7 7 8 8 8 8 7 8 8 8 8 8 7 8 7 7 7 7 8 8 7 8 8 8 8 7 4 
4 7 8 7 8 8 7 7 7 7 8 8 7 7 7 8 7 8 7 7 8 8 7 8 8 7 8 7 8 8 8 8 8 7 7 8 8 8 7 7 8 7 7 7 7 7 7 8 8 7 7 7 7 7 7 7 8 7 8 8 7 8 7 4 
4 4 4 4 4 4 4 4 4 4 4 4 4 4 4 4 4 4 4 4 4 4 4 4 4 4 4 4 4 4 4 4 4 4 4 4 4 4 4 4 4 4 4 4 4 4 4 4 4 4 4 4 4 4 4 4 4 4 4 4 4 4 4 4 
