4 4 4 4 4 4 4 4 4 4 4 4 4 4 4 4 4 4 4 4 4 4 4 4 4 4 4 4 4 4 4 4 4 4 4 4 4 4 4 4 4 4 4 4 4 4 4 4 4 4 4 4 4 4 4 4 4 4 4 4 4 4 4 4 
4 8 8 8 7 7 8 8 7 8 8 7 7 7 7 7 8 7 7 8 7 7 7 8 7 7 8 7 8 7 8 7 8 8 8 7 8 7 7 7 8 8 8 8 7 7 7 8 8 7 8 7 7 7 8 7 8 7 7 7 7 7 7 4 
4 8 8 8 7 7 7 8 8 8 7 8 7 8 7 7 7 8 8 7 8 7 8 7 7 8 8 8 7 7 7 8 7 8 7 7 7 7 7 7 8 8 7 8 8 7 7 8 8 7 7 7 8 7 7 8 7 7 8 7 8 8 7 4 
4 7 8 7 8 8 7 7 8 8 8 7 7 8 7 8 7 8 7 8 7 7 7 8 8 8 7 7 7 8 7 7 7 8 7 8 7 8 7 7 7 8 8 7 7 7 8 8 8 7 7 7 7 8 7 8 7 7 7 7 8 8 8 4 
4 7 8 8 7 7 7 7 8 8 8 7 7 7 8 7 8 8 8 8 7 7 7 8 8 7 8 8 7 7 8 7 8 8 8 8 7 8 7 8 7 8 7 7 8 7 7 7 8 7 7 7 8 7 8 7 8 8 8 8 8 8 7 4 
4 7 7 7 8 8 8 8 7 7 7 8 7 7 8 8 7 7 7 7 8 8 7 8 7 7 7 8 8 7 8 8 8 8 8 8 8 7 7 7 8 7 8 8 8 8 8 7 8 7 7 7 8 8 8 8 8 7 8 8 7 8 7 4 
4 8 7 7 8 7 7 8 8 7 8 7 7 7 8 7 7 7 7 8 8 8 7 8 7 7 7 7 8 7 7 7 7 7 7 7 8 7 8 7 7 8 8 7 8 8 7 8 8 8 8 7 7 7 8 7 7 8 8 8 8 8 8 4 
4 8 8 8 8 7 6 9 8 7 7 7 7 7 7 8 8 7 8 7 8 8 7 7 8 7 8 7 7 8 7 8 7 7 7 7 7 8 7 7 7 8 8 7 8 7 8 8 7 8 7 7 8 7 7 8 7 8 8 7 8 8 8 4 
4 8 7 7 8 9 3 9 8 7 8 7 7 7 8 7 7 8 7 7 8 8 8 8 7 7 8 7 8 7 8 7 8 8 8 7 7 8 8 8 7 7 7 8 8 7 7 8 8 8 8 7 7 7 7 8 8 8 7 7 7 8 7 4 
4 8 7 7 7 9 9 7 7 8 7 7 8 8 7 8 7 8 7 7 8 7 8 7 8 7 8 7 7 8 7 8 8 8 8 7 8 7 8 8 8 8 8 7 8 8 8 7 7 7 8 7 8 7 7 7 7 8 7 7 7 7 8 4 
4 7 8 7 7 7 7 7 8 7 8 8 7 8 7 7 7 7 8 8 7 7 8 7 8 8 7 7 8 8 8 8 8 8 7 7 8 8 8 7 7 7 8 7 7 8 7 7 7 7 7 7 7 8 8 8 7 8 7 7 8 8 8 4 
4 8 8 8 8 7 8 7 7 8 8 7 7 8 7 8 8 8 8 7 7 7 7 7 7 8 8 8 8 8 7 7 7 8 7 7 7 8 8 8 7 8 7 8 7 7 8 7 8 8 7 7 7 8 8 8 8 8 8 8 7 7 7 4 
4 8 8 8 7 7 8 7 7 7 8 8 8 7 7 8 7 8 7 8 8 8 8 7 8 8 8 7 8 7 7 8 7 7 8 8 7 7 7 8 8 7 7 8 8 8 8 7 7 7 8 8 7 7 7 7 7 7 7 8 8 8 7 4 
4 8 8 7 7 7 8 7 8 8 8 7 7 7 8 8 8 8 8 8 8 8 7 8 7 7 8 7 7 7 8 7 8 7 8 8 7 8 8 7 7 8 8 7 8 7 7 7 8 7 8 7 7 8 8 7 7 7 7 8 8 7 8 4 
4 8 7 7 8 8 8 7 7 7 7 7 7 8 7 8 7 8 7 7 7 7 7 8 8 8 8 7 7 8 7 7 7 8 7 7 7 8 8 7 7 8 8 7 8 8 8 7 7 7 7 8 7 7 8 7 7 7 7 8 7 8 8 4 
4 8 8 7 7 8 8 8 8 8 8 7 8 7 8 7 7 7 8 8 7 7 7 7 8 8 7 7 7 7 7 8 7 7 8 8 7 7 8 8 7 8 7 7 7 8 7 8 7 8 8 8 8 7 8 7 8 8 7 8 7 7 8 4 
4 8 7 8 7 8 7 8 8 7 8 8 8 8 7 7 8 7 8 8 8 8 7 8 8 7 8 8 8 8 7 8 8 8 7 7 7 7 8 7 8 8 7 8 8 7 7 7 8 8 7 8 8 8 8 7 8 7 8 8 8 8 8 4 
4 8 8 8 7 8 7 8 8 8 7 7 8 7 7 7 7 7 8 7 7 7 8 8 7 7 8 8 8 7 8 7 7 7 8 8 7 8 7 7 7 7 8 8 7 8 8 7 8 7 8 7 8 7 8 7 8 7 7 8 7 8 7 4 
4 7 7 7 8 8 8 7 7 7 8 8 8 7 8 8 8 8 7 8 7 8 8 7 8 8 7 8 8 8 8 7 8 8 8 8 7 7 7 7 7 8 8 8 7 7 7 8 8 7 8 7 7 7 8 7 7 7 7 7 7 7 8 4 
4 7 7 7 7 7 7 8 7 8 7 7 8 8 8 8 8 7 7 7 8 7 7 8 8 8 7 7 7 7 8 8 8 8 7 7 8 8 8 7 7 8 8 7 8 7 8 8 8 7 7 7 8 7 7 8 8 8 8 8 7 8 7 4 
4 7 8 8 7 7 7 7 8 8 7 7 8 8 7 8 8 7 7 8 8 7 7 8 8 8 7 7 7 8 7 7 8 8 8 7 8 7 7 8 7 7 8 8 7 7 8 8 8 8 8 8 7 8 7 8 8 7 8 7 7 7 8 4 
4 7 8 7 8 8 7 8 7 8 7 8 7 8 7 7 7 7 7 8 7 7 8 7 8 8 7 8 7 7 7 8 7 8 7 8 8 7 8 8 7 7 8 7 8 7 8 8 8 8 8 8 8 7 8 8 7 7 7 8 7 7 8 4 
4 8 8 7 8 8 8 8 8 8 7 7 7 8 7 7 8 8 8 7 7 8 8 8 7 8 7 7 7 7 8 8 8 8 7 7 7 8 8 7 7 7 8 7 7 7 7 8 8 7 8 8 7 7 8 7 8 7 7 8 7 8 8 4 
4 8 7 8 8 8 7 7 8 7 8 8 7 8 8 7 8 8 8 7 7 7 7 7 7 7 7 7 8 7 8 7 7 8 7 8 8 7 8 8 7 7 8 7 7 8 8 8 8 8 7 8 8 8 7 7 8 7 7 7 8 8 8 4 
4 8 7 7 7 7 7 7 8 7 8 7 8 7 8 7 7 7 8 8 7 8 8 8 7 8 7 8 8 7 8 7 7 8 7 8 8 7 8 7 8 8 8 8 7 7 8 8 7 8 7 7 8 8 7 7 7 7 8 8 7 8 8 4 
4 8 7 8 7 7 8 7 7 8 8 7 7 7 7 7 7 8 7 7 8 8 7 7 7 8 7 8 7 8 8 8 7 8 7 7 8 8 8 8 7 7 8 8 7 7 7 7 8 8 8 7 8 7 7 8 7 7 7 7 7 8 7 4 
4 8 7 8 7 7 8 7 7 7 8 8 8 8 7 8 8 8 7 7 7 8 7 7 7 8 7 7 7 8 8 7 8 8 8 8 8 8 8 7 7 7 7 7 7 7 7 8 7 7 7 8 7 7 7 8 8 8 7 7 8 7 8 4 
4 8 8 7 8 8 8 8 8 8 8 8 8 8 8 7 7 7 7 7 8 7 7 7 7 7 7 8 8 7 7 7 7 8 8 7 7 8 8 7 8 8 8 8 8 7 8 8 7 7 7 7 8 7 7 7 7 8 7 8 7 8 7 4 
4 7 7 7 7 7 7 7 7 8 7 8 7 8 8 8 7 7 7 7 7 8 8 8 7 8 8 7 8 8 7 8 7 7 7 8 7 8 7 7 8 8 7 7 7 8 7 8 8 8 8 8 7 7 8 8 8 8 8 7 8 8 7 4 
4 7 8 7 7 8 7 7 8 7 7 8 8 7 8 7 7 8 8 7 8 7 8 7 7 7 8 8 8 8 7 8 7 7 7 8 7 7 7 7 8 8 7 7 7 7 7 7 8 7 8 8 7 8 7 8 7 7 8 8 8 8 8 4 
4 8 7 7 8 8 7 7 7 8 7 7 7 8 8 8 8 8 7 7 8 8 7 8 7 7 7 7 8 8 7 7 8 8 8 8 7 7 7 7 7 8 8 8 7 7 8 8 7 8 7 8 7 7 8 7 7 7 7 8 7 7 7 4 
4 7 7 7 7 7 7 8 7 8 7 8 8 8 8 7 8 8 7 7 8 8 7 7 8 7 7 7 8 7 8 7 7 8 7 8 8 8 8 7 7 7 8 8 7 7 7 7 7 8 8 7 7 8 7 7 7 7 8 8 8 8 7 4 
4 8 8 8 7 7 7 8 7 7 7 7 8 8 7 8 7 7 7 7 7 7 8 7 7 7 7 7 8 8 8 7 7 7 7 7 8 8 8 8 8 8 8 7 7 7 7 7 8 7 7 8 7 7 8 7 8 8 8 8 8 8 8 4 
4 8 8 7 7 8 8 8 8 7 7 7 7 8 7 8 7 7 8 8 7 8 7 7 7 7 7 8 7 7 8 7 7 7 8 8 8 8 7 7 7 8 7 7 8 7 7 8 8 7 8 8 8 7 7 7 7 8 7 7 7 8 8 4 
4 7 7 7 7 7 8 8 8 7 8 8 8 7 8 7 7 8 7 7 8 7 7 8 7 7 8 7 8 8 8 7 7 8 8 7 8 8 8 8 7 8 7 8 8 7 8 7 7 8 8 7 7 7 8 7 7 8 8 7 7 8 7 4 
4 8 8 8 7 8 7 7 8 7 7 8 8 8 7 7 8 8 7 8 8 7 7 8 7 7 7 7 8 8 7 8 8 8 8 7 7 8 7 7 8 7 8 7 7 8 8 8 7 7 8 7 7 8 8 7 7 8 7 8 7 7 8 4 
4 7 8 7 8 8 7 8 7 8 7 7 7 8 8 8 7 8 7 8 8 7 8 8 7 8 7 7 8 7 8 7 7 7 7 7 8 7 8 7 8 7 7 7 7 8 8 7 7 7 8 8 7 7 8 7 7 8 8 7 8 8 7 4 
4 8 8 8 8 7 8 7 7 8 7 7 7 7 7 8 7 7 7 8 7 7 7 7 7 8 7 7 7 8 7 7 8 7 7 8 7 8 7 7 7 8 8 8 8 8 7 8 7 8 8 7 8 8 7 8 8 8 8 7 8 7 7 4 
4 8 7 7 8 8 8 7 7 8 8 8 8 7 8 8 8 7 7 7 8 8 8 7 8 7 7 7 8 8 7 8 8 8 8 7 7 7 8 7 7 8 8 7 8 8 7 7 8 8 7 7 7 7 8 7 8 8 7 7 8 7 7 4 
4 7 8 8 7 8 8 7 7 8 8 8 8 8 8 7 7 7 7 7 8 8 7 7 7 8 8 7 7 8 8 8 8 8 7 7 8 8 7 7 8 7 7 7 8 7 8 7 8 7 7 7 7 7 8 7 7 7 7 8 8 7 8 4 
4 8 8 7 7 7 8 8 8 8 8 8 8 8 8 8 8 7 8 7 8 7 8 7 7 8 8 8 8 8 8 8 7 7 8 8 8 7 7 7 7 7 8 8 8 7 8 7 8 7 8 7 8 8 8 8 8 7 7 7 7 7 8 4 
4 7 8 8 7 8 7 8 7 8 8 8 8 8 8 8 8 8 7 7 7 8 8 7 8 7 8 7 7 8 7 8 8 7 8 8 7 8 7 7 7 7 8 8 7 7 8 8 8 8 7 8 7 8 7 8 8 8 8 8 8 8 8 4 
4 7 7 7 8 8 8 8 8 8 8 8 7 8 7 7 8 8 7 7 7 7 8 8 8 8 7 7 8 8 7 8 7 8 7 7 8 7 7 8 8 8 8 7 7 7 7 7 7 7 7 7 7 8 7 8 8 7 7 7 8 8 7 4 
4 8 7 7 7 7 8 7 8 7 7 7 8 8 7 7 7 7 8 7 8 8 8 7 8 8 8 7 7 7 7 7 7 7 7 7 8 7 7 7 8 7 7 7 8 7 7 8 7 8 7 7 7 8 7 8 8 7 8 7 7 7 8 4 
4 8 8 8 8 8 7 7 8 8 7 7 7 7 7 7 8 7 8 7 8 7 8 7 7 8 8 7 7 7 8 7 7 7 8 7 7 7 8 8 7 8 7 7 7 8 8 8 7 7 7 7 7 7 7 7 8 8 8 7 7 7 8 4 
4 8 8 7 7 7 7 7 7 8 7 7 7 7 7 7 7 7 7 8 7 7 8 7 7 8 8 7 7 8 8 8 8 8 7 8 8 7 8 8 8 7 7 8 8 7 7 8 8 8 7 8 8 8 7 8 7 7 8 7 7 7 8 4 
4 7 7 7 7 8 7 7 7 8 7 7 7 8 8 7 8 7 8 7 7 8 8 8 7 8 7 8 7 7 8 8 7 7 8 7 7 7 8 7 8 7 7 7 7 8 7 7 8 7 8 7 8 7 7 7 8 8 7 8 8 7 8 4 
4 7 7 7 7 7 7 7 8 8 7 7 7 7 8 8 7 8 7 7 8 7 8 8 8 7 7 7 7 7 7 8 7 7 7 8 8 8 7 8 8 8 8 8 8 7 7 8 8 8 7 8 8 7 7 7 8 7 7 7 8 7 8 4 
4 8 7 7 8 7 8 8 7 7 7 8 8 8 7 7 7 8 7 7 7 7 7 7 8 7 7 7 7 8 8 7 7 7 7 7 8 7 7 8 7 8 7 7 8 8 7 7 8 8 7 7 8 7 7 7 7 7 8 8 8 8 7 4 
4 7 8 8 8 7 8 8 8 8 7 7 7 7 8 8 7 7 8 7 7 8 8 8 8 8 7 7 7 8 7 7 7 7 7 8 8 8 7 7 7 8 8 7 7 7 8 7 8 8 7 7 8 8 8 7 8 8 8 7 7 8 7 4 
4 8 8 7 7 8 7 7 8 8 7 7 7 7 8 7 8 8 7 8 8 7 7 7 7 8 7 8 8 7 7 8 7 8 8 7 8 7 8 7 7 7 7 7 7 7 7 7 8 7 8 8 7 7 7 8 8 8 8 8 7 7 8 4 
4 8 8 7 7 8 7 7 8 7 7 7 8 8 7 8 7 7 7 7 8 8 8 8 7 8 7 8 8 7 8 7 7 7 8 7 7 8 7 8 8 7 7 8 8 7 8 8 8 8 7 7 8 7 7 8 7 7 7 8 8 7 8 4 
4 7 8 7 8 8 7 7 7 8 7 8 7 8 7 8 8 8 7 7 7 7 7 8 7 8 7 7 7 7 7 7 8 7 8 8 8 7 8 8 8 8 8 8 7 7 8 8 7 8 7 8 8 8 8 7 7 7 7 8 8 7 7 4 
4 7 8 8 7 8 7 8 8 7 7 8 7 7 7 7 7 8 8 7 8 8 7 7 8 8 7 7 8 7 8 8 7 8 8 7 8 8 7 8 7 8 8 7 7 8 8 8 7 7 7 8 8 7 8 8 7 8 7 7 8 8 8 4 
4 8 7 7 7 7 8 8 8 8 7 8 7 7 7 8 8 7 7 8 7 7 7 7 7 8 8 8 8 8 8 7 7 8 8 7 8 8 8 7 7 8 7 7 8 7 8 8 7 7 7 7 8 7 8 8 8 7 8 7 8 8 8 4 
4 8 8 8 7 8 7 8 8 8 8 7 7 7 8 8 8 8 7 7 7 7 8 8 8 7 8 7 7 8 7 7 8 8 7 8 7 7 8 7 8 8 7 7 7 7 8 8 8 7 7 7 8 8 8 7 7 7 7 7 7 8 7 4 
4 7 8 8 7 8 7 8 8 8 7 8 8 7 7 8 7 7 8 7 7 8 7 7 7 7 7 7 7 7 8 7 8 8 7 7 7 8 7 7 8 7 7 8 8 8 7 8 8 8 7 8 7 8 7 8 7 8 7 7 7 8 8 4 
4 7 8 7 8 7 7 8 7 7 8 7 8 7 7 8 8 7 7 7 8 8 8 8 8 8 8 7 8 7 7 7 8 8 8 8 8 7 7 8 7 8 8 8 7 7 7 8 8 7 7 8 7 7 8 8 7 7 7 8 7 7 8 4 
4 7 8 7 7 7 8 8 8 8 8 8 7 7 7 7 7 7 8 8 8 8 8 7 7 7 8 7 7 8 8 8 7 8 8 8 7 7 8 7 7 8 7 8 8 8 7 7 8 8 8 7 7 8 8 7 8 8 8 8 7 8 7 4 
4 7 7 8 8 7 8 8 8 8 8 8 8 8 7 7 7 8 7 8 7 8 7 8 8 7 8 7 7 7 8 8 8 8 7 7 7 8 8 8 7 8 8 8 8 8 7 8 8 7 7 7 7 7 7 8 7 8 8 8 8 8 7 4 
4 7 7 8 7 8 7 7 8 7 7 7 7 7 8 7 8 7 7 8 7 7 8 7 7 7 8 7 8 7 8 7 8 8 7 8 7 7 7 8 7 7 7 7 8 8 8 7 8 8 8 8 7 7 7 7 7 8 7 7 7 7 8 4 
4 8 8 7 8 8 8 7 7 8 7 8 7 8 7 7 8 8 7 8 7 7 8 8 8 7 7 8 7 7 7 8 7 7 7 8 8 7 8 7 8 7 8 8 8 8 8 8 7 7 8 7 7 7 8 8 7 7 7 8 8 7 8 4 
4 8 7 8 7 8 8 8 8 7 8 7 8 7 8 7 8 7 8 8 7 8 8 7 8 8 7 7 8 8 7 7 7 7 8 7 7 8 7 7 7 8 7 8 8 8 7 8 7 7 8 8 7 7 7 8 8 7 8 7 8 8 8 4 
4 4 4 4 4 4 4 4 4 4 4 4 4 4 4 4 4 4 4 4 4 4 4 4 4 4 4 4 4 4 4 4 4 4 4 4 4 4 4 4 4 4 4 4 4 4 4 4 4 4 4 4 4 4 4 4 4 4 4 4 4 4 4 4 
