50 50 50 50 50 50 50 50 50 50 50 50 50 50 50 50 50 50 50 50 50 50 50 50 50 50 50 50 50 50 50 50 50 50 50 50 50 50 50 50 50 50 50 50 50 50 50 50 50 50 50 50 50 50 50 50 50 50 50 50 50 50 50 50 
50 11 10 11 11 11 9 10 11 11 10 11 9 10 10 10 9 9 9 11 11 9 9 11 10 9 9 10 9 10 10 11 10 10 11 10 9 9 11 11 11 9 11 9 11 9 10 9 11 11 10 9 10 10 10 11 11 11 9 9 9 9 11 50 
50 11 9 10 9 10 10 9 9 9 11 10 9 11 9 11 9 10 9 11 11 10 10 10 11 11 9 9 10 11 10 10 9 9 11 9 10 9 9 9 11 9 11 9 11 10 9 9 9 10 9 9 10 9 11 9 9 9 11 11 10 11 9 50 
50 10 11 9 10 9 10 10 10 11 11 9 10 11 9 9 10 9 9 11 10 9 11 9 10 9 10 11 10 10 11 11 10 11 10 10 10 9 9 11 10 11 11 9 11 10 10 11 9 10 11 9 9 11 9 9 9 9 10 10 11 10 9 50 
50 10 10 9 10 10 9 11 10 10 11 10 10 10 9 10 9 9 10 9 11 11 10 9 11 11 10 9 9 11 10 10 10 11 9 10 9 10 11 11 11 11 9 9 9 10 10 11 10 10 10 11 11 10 10 10 10 11 11 10 11 9 10 50 
50 11 9 11 10 10 11 11 11 9 10 10 9 10 9 11 9 11 9 11 9 11 9 10 10 11 9 9 10 10 10 9 11 10 11 9 9 9 10 10 11 10 9 10 10 10 9 11 11 9 9 9 10 11 10 10 10 11 9 11 11 11 9 50 
50 10 10 9 9 9 10 10 10 10 11 10 11 11 9 9 11 10 9 9 9 10 10 10 10 9 11 11 9 10 11 10 9 10 9 11 9 10 10 10 9 10 11 9 10 11 11 9 11 9 11 9 9 10 10 9 10 10 9 11 10 11 9 50 
50 9 10 10 9 11 10 10 10 11 9 9 10 9 9 9 11 9 9 11 11 9 9 11 11 11 10 11 9 9 11 10 9 9 11 9 10 11 9 10 11 9 11 11 10 9 11 11 11 9 10 11 10 10 11 10 11 11 10 9 11 11 9 50 
50 11 9 10 11 10 9 9 10 10 11 11 10 11 9 9 9 11 10 11 10 10 9 10 11 10 11 10 9 10 9 10 11 10 10 9 10 10 9 9 10 11 9 9 9 10 9 9 10 11 11 11 11 9 11 11 11 9 9 9 11 10 9 50 
50 9 10 10 10 10 9 9 11 10 11 9 9 9 9 9 9 10 10 10 11 10 9 10 10 10 11 10 9 10 11 11 11 10 11 10 10 9 9 9 10 10 10 10 9 10 11 9 10 9 11 10 9 10 10 11 11 10 11 9 10 9 10 50 
50 11 10 9 11 10 11 10 11 9 9 10 11 9 11 11 11 11 11 9 10 10 10 9 9 10 11 11 9 11 11 9 10 11 11 10 9 10 11 9 10 11 10 10 9 11 9 10 10 10 10 11 11 10 10 10 10 11 9 10 10 11 9 50 
50 11 10 10 11 11 9 10 11 9 11 10 9 9 10 10 10 10 10 9 11 9 9 10 10 10 10 9 10 9 9 10 9 9 10 11 11 11 10 9 9 9 9 10 9 11 9 11 10 10 9 9 9 11 9 10 10 9 10 9 10 9 10 50 
50 11 10 10 10 9 11 11 11 10 10 9 11 9 10 9 11 10 10 9 9 9 9 11 9 10 9 10 10 11 9 10 10 11 9 11 9 9 11 9 9 10 9 10 11 11 10 10 10 9 9 9 10 9 11 10 9 10 11 9 9 9 9 50 
50 9 10 9 9 10 9 10 10 10 9 10 10 10 11 10 9 10 10 9 11 11 9 9 9 9 10 9 11 9 11 9 11 11 10 10 10 9 10 9 9 11 9 9 9 11 9 10 10 11 10 11 11 9 10 11 10 11 9 10 10 11 11 50 
50 11 10 10 10 9 11 11 9 10 11 9 11 9 11 10 9 9 10 9 9 9 10 11 11 10 11 10 9 10 10 9 9 11 10 9 10 10 11 11 9 9 11 9 10 11 10 10 10 11 9 11 11 11 11 11 9 9 10 9 10 10 10 50 
50 11 10 11 11 9 10 10 9 10 11 9 9 10 11 9 9 10 10 11 11 10 10 11 9 10 10 11 9 9 11 10 11 9 11 10 11 10 9 9 9 9 10 9 11 11 10 9 11 11 10 9 9 11 9 11 9 10 10 11 10 10 9 50 
50 10 9 10 9 11 10 11 9 11 10 11 10 10 9 10 11 11 10 9 10 11 10 11 11 9 10 10 11 10 10 9 10 9 9 9 11 11 11 10 11 10 9 9 11 9 10 9 11 10 11 9 9 9 11 10 11 11 10 11 10 10 10 50 
50 9 11 11 9 9 11 11 9 11 11 10 11 9 11 9 11 11 9 10 10 11 11 10 11 9 9 9 9 10 10 9 10 9 10 9 10 11 9 11 11 10 11 9 10 10 11 9 10 11 9 10 10 9 9 9 10 10 11 9 10 11 9 50 
50 10 10 9 9 10 10 9 10 11 11 9 10 11 9 11 10 9 9 9 11 11 11 10 9 11 9 10 9 10 9 9 10 11 10 9 11 9 9 10 9 9 11 10 9 10 10 11 10 10 9 11 10 9 10 11 10 10 11 9 10 11 9 50 
50 10 11 10 9 11 9 11 9 10 10 9 10 9 9 10 11 9 11 10 10 9 10 10 10 10 11 10 11 10 9 10 9 11 9 10 10 9 11 9 9 9 11 11 10 11 11 10 10 10 10 11 11 11 11 9 11 11 10 9 10 9 11 50 
50 10 9 9 9 9 10 11 9 9 9 11 11 10 10 9 9 9 9 11 11 10 9 10 9 11 9 11 11 10 11 11 11 9 11 11 10 10 10 9 10 10 9 11 11 10 10 9 10 9 11 11 11 9 10 9 9 11 11 11 11 9 9 50 
50 9 9 9 11 10 11 9 9 11 9 10 10 10 10 10 11 11 9 11 9 10 9 9 9 9 9 11 10 10 10 10 9 9 11 9 9 11 9 10 10 11 11 10 9 10 9 11 10 9 10 9 11 9 11 11 11 11 10 9 10 11 11 50 
50 11 9 9 10 9 11 9 11 10 11 11 11 9 11 10 10 10 10 9 10 10 11 11 9 9 9 9 10 10 10 9 11 9 11 11 10 11 10 11 9 10 9 10 10 11 11 11 11 11 10 11 10 11 10 11 11 11 11 10 11 9 9 50 
50 10 9 9 10 11 10 10 11 11 10 9 9 10 10 9 10 9 10 9 9 11 9 9 10 10 10 10 11 10 10 10 9 11 9 11 11 11 9 9 9 11 10 11 10 11 9 11 10 11 9 11 10 11 9 11 9 10 9 10 11 11 10 50 
50 11 9 10 10 11 10 10 11 9 11 10 10 9 10 9 11 9 9 10 10 9 9 9 9 10 11 9 11 10 10 9 9 11 10 10 11 9 9 11 9 9 9 10 9 10 10 11 9 11 11 11 11 10 10 10 11 9 11 11 9 9 10 50 
50 9 10 9 10 10 9 9 10 10 10 11 10 9 10 11 11 9 10 10 9 10 11 11 9 9 11 9 9 11 11 11 11 10 9 9 10 10 10 11 9 9 9 9 9 11 11 10 11 11 9 9 10 9 10 11 10 9 9 9 10 10 9 50 
50 11 10 11 9 11 9 10 11 9 11 11 9 9 11 9 10 11 10 11 10 9 11 9 9 10 9 10 11 10 11 11 9 11 10 10 11 10 9 10 9 9 9 11 11 9 9 11 10 9 11 11 10 9 11 9 10 11 10 9 10 9 10 50 
50 9 11 11 9 9 11 9 9 10 9 9 11 11 10 9 9 9 10 9 11 10 11 9 10 11 9 10 10 9 10 10 11 10 11 10 10 9 10 10 11 9 10 9 10 10 11 9 9 10 9 11 10 9 11 10 10 11 9 9 10 9 10 50 
50 11 11 10 9 9 11 10 11 11 9 10 11 11 11 9 11 10 11 10 9 11 10 11 11 10 9 10 9 9 9 9 11 9 10 10 10 11 10 11 11 11 11 10 10 9 11 10 10 10 9 11 9 11 10 10 10 11 9 10 10 11 10 50 
50 9 11 11 9 9 11 11 9 10 10 9 11 11 9 11 11 11 9 11 11 9 11 10 11 11 11 10 10 10 10 11 10 11 9 9 9 10 10 11 10 10 10 10 10 9 11 10 9 11 10 9 11 10 11 9 11 11 10 11 11 11 10 50 
50 9 9 9 11 9 10 10 11 10 10 10 10 10 11 9 10 9 9 10 9 10 9 11 9 11 11 9 10 9 10 9 10 11 9 11 11 9 10 10 11 10 11 11 9 11 10 9 9 9 10 9 10 10 10 11 10 9 9 11 9 9 10 50 
50 9 11 9 10 10 11 10 11 9 9 11 10 9 9 10 9 9 11 10 11 9 9 11 11 11 11 9 10 9 11 10 10 11 11 10 10 9 9 11 10 9 10 10 10 11 10 9 9 11 9 10 11 10 10 11 11 9 10 11 9 10 9 50 
50 9 9 9 11 11 9 9 9 10 11 9 10 9 11 9 10 9 10 11 11 9 11 10 9 9 9 9 10 10 9 11 10 9 11 9 9 9 9 10 10 10 9 11 10 11 10 9 11 11 9 11 10 11 11 9 11 11 10 9 11 9 11 50 
50 10 9 11 9 9 11 10 9 10 11 11 9 9 10 10 9 10 11 9 9 10 11 10 11 11 11 10 11 11 9 11 10 11 11 10 10 9 10 10 10 10 9 9 9 10 9 10 10 10 11 11 11 9 9 9 11 9 9 11 10 10 11 50 
50 9 9 10 9 10 11 9 9 10 10 9 10 11 10 11 9 9 11 9 10 10 9 9 10 10 11 9 10 10 10 9 11 9 10 9 11 11 10 9 11 11 10 10 10 9 9 11 9 9 11 10 10 11 9 11 11 10 9 9 10 10 11 50 
50 9 9 11 11 10 11 11 11 11 10 9 9 11 10 9 9 9 10 10 11 9 10 11 10 10 10 10 11 9 9 10 11 9 11 11 10 9 9 11 9 10 10 10 11 9 10 9 9 11 9 10 11 10 10 9 10 9 9 9 11 10 9 50 
50 9 10 9 11 9 9 11 10 11 9 10 11 11 11 9 11 11 10 11 10 11 10 10 11 9 11 10 9 9 11 9 11 11 11 10 9 9 9 9 11 10 9 10 9 9 11 10 11 11 11 11 11 9 11 10 10 9 10 9 10 10 9 50 
50 9 9 9 10 10 11 10 10 10 11 9 9 9 11 11 10 11 10 11 11 10 11 9 9 10 9 11 9 11 11 11 10 10 10 10 9 10 9 10 10 11 9 10 9 9 11 10 10 10 10 9 10 11 10 10 11 10 9 9 11 9 11 50 
50 11 10 11 10 11 9 11 9 10 9 10 9 11 10 9 10 11 11 9 10 11 10 11 9 11 9 9 9 11 10 10 11 9 9 10 11 11 10 62 9 11 9 9 10 10 11 10 11 9 9 10 10 9 11 9 9 9 11 11 11 9 9 50 
50 9 11 10 11 11 9 9 9 10 10 11 9 10 10 10 11 11 11 11 9 10 10 10 10 10 10 10 11 11 10 10 10 10 11 9 11 9 9 9 10 10 11 9 9 11 10 10 9 11 11 11 10 10 10 11 10 9 11 11 11 11 10 50 
50 10 11 9 9 11 10 11 9 9 11 10 11 9 11 9 10 11 10 11 10 11 10 10 9 9 11 10 9 11 11 9 11 11 9 10 9 11 11 10 10 10 10 10 9 9 9 9 10 9 11 9 11 10 11 11 9 11 10 9 11 9 10 50 
50 11 10 11 9 9 9 11 9 9 10 10 9 10 9 11 9 10 10 11 9 10 10 10 9 9 11 11 9 9 9 9 9 10 9 10 10 9 10 9 10 9 10 10 11 10 11 11 11 9 9 10 9 9 10 11 11 10 10 9 10 9 9 50 
50 10 11 9 11 9 9 11 9 11 9 10 11 11 10 11 9 10 11 9 11 9 11 9 11 10 9 11 11 9 10 10 11 9 9 10 11 9 11 9 10 9 10 11 10 9 10 9 10 10 10 10 9 9 9 10 10 11 9 9 10 11 9 50 
50 9 10 9 10 11 10 11 9 9 11 10 11 10 9 10 10 10 10 11 9 10 10 10 9 9 10 10 10 10 10 10 11 10 10 9 9 9 11 11 10 10 9 9 10 9 9 11 11 11 11 9 9 10 11 11 9 11 11 9 9 9 11 50 
50 10 10 10 11 9 10 9 9 10 11 9 10 10 11 9 9 10 11 9 9 10 11 10 11 9 10 11 11 11 10 9 9 10 9 10 10 10 9 11 10 11 10 11 11 11 11 11 10 9 10 11 10 9 10 9 10 11 11 10 9 10 11 50 
50 9 10 11 9 9 11 9 10 10 9 9 11 9 9 10 10 11 9 11 11 11 9 9 11 11 11 10 9 11 11 9 10 9 9 9 10 10 9 9 9 11 10 11 11 9 11 9 9 9 11 11 9 11 11 11 11 11 11 10 10 9 11 50 
50 11 9 10 11 9 10 10 10 10 10 11 10 11 10 10 9 10 10 11 11 11 9 11 11 10 11 10 11 10 11 9 10 11 11 10 11 11 10 11 9 10 9 10 10 9 9 10 11 10 10 10 9 9 10 11 10 9 10 11 10 10 9 50 
50 10 10 9 11 11 9 10 9 11 10 9 10 9 9 9 9 10 11 11 9 9 10 9 11 11 10 11 9 9 11 11 10 10 9 11 9 9 10 9 10 11 11 10 10 10 10 10 9 9 10 9 10 9 10 11 10 11 11 11 11 10 9 50 
50 10 10 11 11 11 10 10 10 9 10 11 11 9 11 11 11 10 11 11 11 10 10 10 10 9 11 11 9 9 11 10 11 11 11 11 10 11 11 10 10 10 11 10 10 10 11 11 9 11 9 9 11 9 10 9 11 10 10 9 10 10 10 50 
50 11 11 10 9 11 10 9 10 10 10 10 11 11 11 9 9 11 11 11 11 11 11 10 9 10 11 10 11 11 11 10 10 11 11 9 11 9 11 11 10 9 9 9 9 9 11 11 9 11 11 9 9 10 9 9 11 10 11 9 9 11 9 50 
50 11 10 10 9 11 10 9 11 9 9 9 9 11 10 9 11 10 10 9 9 11 11 9 9 9 11 11 9 9 10 9 9 11 9 9 11 11 11 9 11 10 11 11 10 9 9 10 10 9 10 9 10 9 11 11 10 11 11 10 9 9 10 50 
50 11 10 10 9 11 11 10 9 11 9 11 10 9 10 9 11 10 10 11 11 11 10 10 10 11 11 11 9 11 10 9 10 11 10 11 10 10 11 11 9 10 11 10 10 11 10 10 11 10 10 11 9 10 10 11 11 10 9 9 10 11 9 50 
50 9 11 10 9 9 10 10 11 9 10 10 11 11 10 10 9 9 11 9 11 9 11 11 9 11 10 11 9 11 11 9 9 11 11 9 10 9 11 9 10 10 11 9 9 11 11 9 10 10 11 11 9 10 9 11 9 11 11 9 10 10 9 50 
50 11 9 11 10 9 10 10 9 11 9 10 9 11 10 10 10 11 9 11 10 10 11 11 11 9 10 10 10 10 10 11 11 10 9 9 11 9 10 10 10 10 10 9 11 11 10 10 9 11 10 10 11 11 10 9 10 9 11 9 11 11 11 50 
50 9 10 11 9 9 11 11 10 9 11 9 11 9 10 9 10 10 11 9 9 11 11 10 11 10 9 10 9 10 9 11 11 9 10 10 9 9 10 10 10 9 9 10 11 11 10 11 9 11 9 10 10 10 10 11 11 10 10 9 11 10 9 50 
50 11 10 10 10 10 11 11 10 9 9 11 11 9 10 9 9 10 9 11 10 11 11 11 11 11 9 9 10 10 9 9 10 9 9 9 10 10 11 10 10 9 10 9 9 10 10 10 10 11 9 11 9 10 11 11 10 9 9 9 9 11 10 50 
50 9 10 11 10 10 10 10 9 10 11 11 9 10 11 11 11 9 11 9 9 9 11 11 11 10 11 10 10 11 9 10 11 9 9 9 10 9 10 11 11 9 10 10 10 10 11 10 9 9 11 11 9 9 10 9 10 11 10 9 10 11 10 50 
50 11 10 11 10 10 10 11 10 9 11 9 11 10 11 9 11 9 9 9 9 10 11 9 11 9 9 11 11 9 9 9 10 9 10 10 11 11 10 9 10 9 11 9 11 9 9 11 10 11 10 11 11 10 9 10 10 10 9 9 10 11 9 50 
50 11 10 9 11 11 11 9 11 11 9 9 9 9 9 10 11 11 11 9 10 9 10 10 10 9 9 10 10 10 10 11 11 11 11 9 9 11 9 11 9 9 9 9 10 9 9 10 10 9 10 9 11 11 10 10 9 10 11 9 11 11 11 50 
50 11 11 9 11 11 10 9 9 9 9 10 10 11 10 9 9 10 10 9 9 10 10 10 10 9 9 9 10 9 10 11 10 10 9 11 9 9 11 9 10 11 11 11 11 11 9 11 9 11 9 11 10 9 11 10 9 9 10 10 9 10 9 50 
50 9 11 10 10 10 10 10 10 11 9 10 11 11 11 11 10 9 9 11 9 9 11 11 10 11 9 11 11 11 10 10 11 11 11 11 10 9 9 9 9 10 10 9 9 11 10 10 10 11 11 10 11 9 11 9 11 9 10 9 11 9 11 50 
50 11 10 10 11 9 9 9 10 9 11 9 11 10 9 9 9 10 9 9 9 10 9 9 9 9 11 10 9 9 9 10 9 11 10 9 11 10 9 11 9 11 9 9 10 11 9 11 9 11 10 11 9 11 10 10 9 10 9 11 9 9 11 50 
50 11 9 9 10 11 9 9 9 9 9 9 10 11 10 9 11 10 10 9 9 10 10 9 11 9 10 10 10 9 11 9 11 9 9 11 9 9 11 9 9 10 11 10 10 11 10 9 10 10 9 11 11 9 10 11 10 9 10 11 10 9 11 50 
50 50 50 50 50 50 50 50 50 50 50 50 50 50 50 50 50 50 50 50 50 50 50 50 50 50 50 50 50 50 50 50 50 50 50 50 50 50 50 50 50 50 50 50 50 50 50 50 50 50 50 50 50 50 50 50 50 50 50 50 50 50 50 50 
