0 3 1 8 5 8 1 6 2 9 
8 5 9 6 0 5 9 6 2 2 
3 0 6 4 0 6 6 0 4 5 
9 7 4 5 1 2 5 7 9 7 
6 1 5 9 9 0 8 2 4 5 
3 6 5 8 6 8 4 9 2 2 
2 7 8 7 0 6 4 2 9 1 
5 4 6 4 3 8 3 5 4 6 
5 5 6 3 3 6 9 2 2 4 
2 6 2 6 0 0 7 2 7 9 
