9 8 7 5 9 2 5 0 8 3 
0 7 9 2 3 5 9 1 3 3 
4 5 0 6 6 6 6 6 3 1 
8 1 3 2 4 1 8 1 7 2 
5 8 1 3 2 5 5 6 5 3 
1 7 9 7 1 5 5 1 0 4 
7 0 1 9 9 7 3 1 3 5 
0 2 2 1 1 0 4 8 8 6 
2 6 7 5 2 6 6 5 8 1 
5 8 3 7 2 8 8 8 7 8 
